5 6
0 0 2 2 0 0
4 4 3 3 0 0
4 0 4 2 0 3
4 4 3 1 2 3
0 0 3 2 3 4
4 4
2 0 1
2 2 1
2 3 1